%%%%%%%%%%%%%%%%%%%%
%....%...  ...%....%
%.%%.%.%%  %%.%.%%.%
%.%o...      ...o%.%
%.%%.%.%%%%%%.%.%%.%
%......      ......%
%.%%...%%  %%...%%.%
%.%..%...  ...%..%.%
%.%%.%.%%%%%%.%.%%.%
%......      ......%
% %%%%%%%%%%%%%%%% %
%       1%%2       %
%%%%%% %%%%%% %%%%%%
%%%%%% 53%%46 %%%%%%
%%%%%%%%%%%%%%%%%%%%
