%%%%%%%%%%%%
%..     624%
%..    %%%%%
%%%%%    ..%
%135     ..%
%%%%%%%%%%%%
